1111111111111111111111111
1000000000000000000000101
10E00000000000C0000000001
1000000000000000000000101
10010000000000C0000000001
1001011000000000000000101
10010000000000C0000000001
1001111000001100001000001
100000C000001100C00000001
10C010C001000000001000001
1CPC00C00000001000000C001
10C00010000001000C0000001
1111111111111111111111111
